Epi_date_V3,Year,Cases,7-Day Average,Cumulative Cases,AsOf
05/10/2022,2022,1,0,1,Data as Reported to CDC as of 27 Feb 2024 2:00 PM EDT
05/11/2022,2022,5,0,6,Data as Reported to CDC as of 27 Feb 2024 2:00 PM EDT
05/12/2022,2022,0,0,6,Data as Reported to CDC as of 27 Feb 2024 2:00 PM EDT
05/13/2022,2022,0,0,6,Data as Reported to CDC as of 27 Feb 2024 2:00 PM EDT
05/14/2022,2022,0,0,6,Data as Reported to CDC as of 27 Feb 2024 2:00 PM EDT
05/15/2022,2022,2,0,8,Data as Reported to CDC as of 27 Feb 2024 2:00 PM EDT
05/16/2022,2022,7,2.142857074737549,15,Data as Reported to CDC as of 27 Feb 2024 2:00 PM EDT
05/17/2022,2022,3,2.4285714626312256,18,Data as Reported to CDC as of 27 Feb 2024 2:00 PM EDT
05/18/2022,2022,2,2,20,Data as Reported to CDC as of 27 Feb 2024 2:00 PM EDT
05/19/2022,2022,3,2.4285714626312256,23,Data as Reported to CDC as of 27 Feb 2024 2:00 PM EDT
05/20/2022,2022,0,2.4285714626312256,23,Data as Reported to CDC as of 27 Feb 2024 2:00 PM EDT
05/21/2022,2022,1,2.5714285373687744,24,Data as Reported to CDC as of 27 Feb 2024 2:00 PM EDT
05/22/2022,2022,1,2.4285714626312256,25,Data as Reported to CDC as of 27 Feb 2024 2:00 PM EDT
05/23/2022,2022,3,1.8571428060531616,28,Data as Reported to CDC as of 27 Feb 2024 2:00 PM EDT
05/24/2022,2022,3,1.8571428060531616,31,Data as Reported to CDC as of 27 Feb 2024 2:00 PM EDT
05/25/2022,2022,2,1.8571428060531616,33,Data as Reported to CDC as of 27 Feb 2024 2:00 PM EDT
05/26/2022,2022,2,1.7142857313156128,35,Data as Reported to CDC as of 27 Feb 2024 2:00 PM EDT
05/27/2022,2022,4,2.2857143878936768,39,Data as Reported to CDC as of 27 Feb 2024 2:00 PM EDT
05/28/2022,2022,0,2.142857074737549,39,Data as Reported to CDC as of 27 Feb 2024 2:00 PM EDT
05/29/2022,2022,6,2.857142925262451,45,Data as Reported to CDC as of 27 Feb 2024 2:00 PM EDT
05/30/2022,2022,8,3.5714285373687744,53,Data as Reported to CDC as of 27 Feb 2024 2:00 PM EDT
05/31/2022,2022,5,3.857142925262451,58,Data as Reported to CDC as of 27 Feb 2024 2:00 PM EDT
06/01/2022,2022,9,4.857142925262451,67,Data as Reported to CDC as of 27 Feb 2024 2:00 PM EDT
06/02/2022,2022,12,6.285714149475098,79,Data as Reported to CDC as of 27 Feb 2024 2:00 PM EDT
06/03/2022,2022,7,6.714285850524902,86,Data as Reported to CDC as of 27 Feb 2024 2:00 PM EDT
06/04/2022,2022,5,7.4285712242126465,91,Data as Reported to CDC as of 27 Feb 2024 2:00 PM EDT
06/05/2022,2022,6,7.4285712242126465,97,Data as Reported to CDC as of 27 Feb 2024 2:00 PM EDT
06/06/2022,2022,19,9,116,Data as Reported to CDC as of 27 Feb 2024 2:00 PM EDT
06/07/2022,2022,21,11.285714149475098,137,Data as Reported to CDC as of 27 Feb 2024 2:00 PM EDT
06/08/2022,2022,12,11.714285850524902,149,Data as Reported to CDC as of 27 Feb 2024 2:00 PM EDT
06/09/2022,2022,6,10.857142448425293,155,Data as Reported to CDC as of 27 Feb 2024 2:00 PM EDT
06/10/2022,2022,23,13.142857551574707,178,Data as Reported to CDC as of 27 Feb 2024 2:00 PM EDT
06/11/2022,2022,11,14,189,Data as Reported to CDC as of 27 Feb 2024 2:00 PM EDT
06/12/2022,2022,25,16.714284896850586,214,Data as Reported to CDC as of 27 Feb 2024 2:00 PM EDT
06/13/2022,2022,26,17.714284896850586,240,Data as Reported to CDC as of 27 Feb 2024 2:00 PM EDT
06/14/2022,2022,25,18.285715103149414,265,Data as Reported to CDC as of 27 Feb 2024 2:00 PM EDT
06/15/2022,2022,33,21.285715103149414,298,Data as Reported to CDC as of 27 Feb 2024 2:00 PM EDT
06/16/2022,2022,26,24.14285659790039,324,Data as Reported to CDC as of 27 Feb 2024 2:00 PM EDT
06/17/2022,2022,32,25.428571701049805,356,Data as Reported to CDC as of 27 Feb 2024 2:00 PM EDT
06/18/2022,2022,26,27.571428298950195,382,Data as Reported to CDC as of 27 Feb 2024 2:00 PM EDT
06/19/2022,2022,34,28.85714340209961,416,Data as Reported to CDC as of 27 Feb 2024 2:00 PM EDT
06/20/2022,2022,41,31,457,Data as Reported to CDC as of 27 Feb 2024 2:00 PM EDT
06/21/2022,2022,43,33.57143020629883,500,Data as Reported to CDC as of 27 Feb 2024 2:00 PM EDT
06/22/2022,2022,63,37.85714340209961,563,Data as Reported to CDC as of 27 Feb 2024 2:00 PM EDT
06/23/2022,2022,56,42.14285659790039,619,Data as Reported to CDC as of 27 Feb 2024 2:00 PM EDT
06/24/2022,2022,50,44.71428680419922,669,Data as Reported to CDC as of 27 Feb 2024 2:00 PM EDT
06/25/2022,2022,54,48.71428680419922,723,Data as Reported to CDC as of 27 Feb 2024 2:00 PM EDT
06/26/2022,2022,67,53.42856979370117,790,Data as Reported to CDC as of 27 Feb 2024 2:00 PM EDT
06/27/2022,2022,98,61.57143020629883,888,Data as Reported to CDC as of 27 Feb 2024 2:00 PM EDT
06/28/2022,2022,90,68.28571319580078,978,Data as Reported to CDC as of 27 Feb 2024 2:00 PM EDT
06/29/2022,2022,79,70.57142639160156,1057,Data as Reported to CDC as of 27 Feb 2024 2:00 PM EDT
06/30/2022,2022,117,79.28571319580078,1174,Data as Reported to CDC as of 27 Feb 2024 2:00 PM EDT
07/01/2022,2022,136,91.57142639160156,1310,Data as Reported to CDC as of 27 Feb 2024 2:00 PM EDT
07/02/2022,2022,128,102.14286041259766,1438,Data as Reported to CDC as of 27 Feb 2024 2:00 PM EDT
07/03/2022,2022,130,111.14286041259766,1568,Data as Reported to CDC as of 27 Feb 2024 2:00 PM EDT
07/04/2022,2022,162,120.28571319580078,1730,Data as Reported to CDC as of 27 Feb 2024 2:00 PM EDT
07/05/2022,2022,186,134,1916,Data as Reported to CDC as of 27 Feb 2024 2:00 PM EDT
07/06/2022,2022,179,148.2857208251953,2095,Data as Reported to CDC as of 27 Feb 2024 2:00 PM EDT
07/07/2022,2022,182,157.57142639160156,2277,Data as Reported to CDC as of 27 Feb 2024 2:00 PM EDT
07/08/2022,2022,247,173.42857360839844,2524,Data as Reported to CDC as of 27 Feb 2024 2:00 PM EDT
07/09/2022,2022,191,182.42857360839844,2715,Data as Reported to CDC as of 27 Feb 2024 2:00 PM EDT
07/10/2022,2022,222,195.57142639160156,2937,Data as Reported to CDC as of 27 Feb 2024 2:00 PM EDT
07/11/2022,2022,348,222.14285278320312,3285,Data as Reported to CDC as of 27 Feb 2024 2:00 PM EDT
07/12/2022,2022,237,229.42857360839844,3522,Data as Reported to CDC as of 27 Feb 2024 2:00 PM EDT
07/13/2022,2022,277,243.42857360839844,3799,Data as Reported to CDC as of 27 Feb 2024 2:00 PM EDT
07/14/2022,2022,304,260.8571472167969,4103,Data as Reported to CDC as of 27 Feb 2024 2:00 PM EDT
07/15/2022,2022,356,276.4285583496094,4459,Data as Reported to CDC as of 27 Feb 2024 2:00 PM EDT
07/16/2022,2022,257,285.8571472167969,4716,Data as Reported to CDC as of 27 Feb 2024 2:00 PM EDT
07/17/2022,2022,248,289.5714416503906,4964,Data as Reported to CDC as of 27 Feb 2024 2:00 PM EDT
07/18/2022,2022,417,299.4285583496094,5381,Data as Reported to CDC as of 27 Feb 2024 2:00 PM EDT
07/19/2022,2022,330,312.71429443359375,5711,Data as Reported to CDC as of 27 Feb 2024 2:00 PM EDT
07/20/2022,2022,376,326.8571472167969,6087,Data as Reported to CDC as of 27 Feb 2024 2:00 PM EDT
07/21/2022,2022,336,331.4285583496094,6423,Data as Reported to CDC as of 27 Feb 2024 2:00 PM EDT
07/22/2022,2022,358,331.71429443359375,6781,Data as Reported to CDC as of 27 Feb 2024 2:00 PM EDT
07/23/2022,2022,310,339.28570556640625,7091,Data as Reported to CDC as of 27 Feb 2024 2:00 PM EDT
07/24/2022,2022,329,350.8571472167969,7420,Data as Reported to CDC as of 27 Feb 2024 2:00 PM EDT
07/25/2022,2022,509,364,7929,Data as Reported to CDC as of 27 Feb 2024 2:00 PM EDT
07/26/2022,2022,401,374.1428527832031,8330,Data as Reported to CDC as of 27 Feb 2024 2:00 PM EDT
07/27/2022,2022,461,386.28570556640625,8791,Data as Reported to CDC as of 27 Feb 2024 2:00 PM EDT
07/28/2022,2022,425,399,9216,Data as Reported to CDC as of 27 Feb 2024 2:00 PM EDT
07/29/2022,2022,456,413,9672,Data as Reported to CDC as of 27 Feb 2024 2:00 PM EDT
07/30/2022,2022,375,422.28570556640625,10047,Data as Reported to CDC as of 27 Feb 2024 2:00 PM EDT
07/31/2022,2022,363,427.1428527832031,10410,Data as Reported to CDC as of 27 Feb 2024 2:00 PM EDT
08/01/2022,2022,645,446.5714416503906,11055,Data as Reported to CDC as of 27 Feb 2024 2:00 PM EDT
08/02/2022,2022,480,457.8571472167969,11535,Data as Reported to CDC as of 27 Feb 2024 2:00 PM EDT
08/03/2022,2022,454,456.8571472167969,11989,Data as Reported to CDC as of 27 Feb 2024 2:00 PM EDT
08/04/2022,2022,449,460.28570556640625,12438,Data as Reported to CDC as of 27 Feb 2024 2:00 PM EDT
08/05/2022,2022,489,465,12927,Data as Reported to CDC as of 27 Feb 2024 2:00 PM EDT
08/06/2022,2022,389,467,13316,Data as Reported to CDC as of 27 Feb 2024 2:00 PM EDT
08/07/2022,2022,355,465.8571472167969,13671,Data as Reported to CDC as of 27 Feb 2024 2:00 PM EDT
08/08/2022,2022,515,447.28570556640625,14186,Data as Reported to CDC as of 27 Feb 2024 2:00 PM EDT
08/09/2022,2022,424,439.28570556640625,14610,Data as Reported to CDC as of 27 Feb 2024 2:00 PM EDT
08/10/2022,2022,463,440.5714416503906,15073,Data as Reported to CDC as of 27 Feb 2024 2:00 PM EDT
08/11/2022,2022,411,435.1428527832031,15484,Data as Reported to CDC as of 27 Feb 2024 2:00 PM EDT
08/12/2022,2022,410,423.8571472167969,15894,Data as Reported to CDC as of 27 Feb 2024 2:00 PM EDT
08/13/2022,2022,363,420.1428527832031,16257,Data as Reported to CDC as of 27 Feb 2024 2:00 PM EDT
08/14/2022,2022,317,414.71429443359375,16574,Data as Reported to CDC as of 27 Feb 2024 2:00 PM EDT
08/15/2022,2022,484,410.28570556640625,17058,Data as Reported to CDC as of 27 Feb 2024 2:00 PM EDT
08/16/2022,2022,338,398,17396,Data as Reported to CDC as of 27 Feb 2024 2:00 PM EDT
08/17/2022,2022,346,381.28570556640625,17742,Data as Reported to CDC as of 27 Feb 2024 2:00 PM EDT
08/18/2022,2022,418,382.28570556640625,18160,Data as Reported to CDC as of 27 Feb 2024 2:00 PM EDT
08/19/2022,2022,406,381.71429443359375,18566,Data as Reported to CDC as of 27 Feb 2024 2:00 PM EDT
08/20/2022,2022,355,380.5714416503906,18921,Data as Reported to CDC as of 27 Feb 2024 2:00 PM EDT
08/21/2022,2022,285,376,19206,Data as Reported to CDC as of 27 Feb 2024 2:00 PM EDT
08/22/2022,2022,361,358.4285583496094,19567,Data as Reported to CDC as of 27 Feb 2024 2:00 PM EDT
08/23/2022,2022,311,354.5714416503906,19878,Data as Reported to CDC as of 27 Feb 2024 2:00 PM EDT
08/24/2022,2022,322,351.1428527832031,20200,Data as Reported to CDC as of 27 Feb 2024 2:00 PM EDT
08/25/2022,2022,309,335.5714416503906,20509,Data as Reported to CDC as of 27 Feb 2024 2:00 PM EDT
08/26/2022,2022,323,323.71429443359375,20832,Data as Reported to CDC as of 27 Feb 2024 2:00 PM EDT
08/27/2022,2022,249,308.5714416503906,21081,Data as Reported to CDC as of 27 Feb 2024 2:00 PM EDT
08/28/2022,2022,248,303.28570556640625,21329,Data as Reported to CDC as of 27 Feb 2024 2:00 PM EDT
08/29/2022,2022,312,296.28570556640625,21641,Data as Reported to CDC as of 27 Feb 2024 2:00 PM EDT
08/30/2022,2022,240,286.1428527832031,21881,Data as Reported to CDC as of 27 Feb 2024 2:00 PM EDT
08/31/2022,2022,233,273.4285583496094,22114,Data as Reported to CDC as of 27 Feb 2024 2:00 PM EDT
09/01/2022,2022,330,276.4285583496094,22444,Data as Reported to CDC as of 27 Feb 2024 2:00 PM EDT
09/02/2022,2022,273,269.28570556640625,22717,Data as Reported to CDC as of 27 Feb 2024 2:00 PM EDT
09/03/2022,2022,202,262.5714416503906,22919,Data as Reported to CDC as of 27 Feb 2024 2:00 PM EDT
09/04/2022,2022,171,251.57142639160156,23090,Data as Reported to CDC as of 27 Feb 2024 2:00 PM EDT
09/05/2022,2022,244,241.85714721679688,23334,Data as Reported to CDC as of 27 Feb 2024 2:00 PM EDT
09/06/2022,2022,238,241.57142639160156,23572,Data as Reported to CDC as of 27 Feb 2024 2:00 PM EDT
09/07/2022,2022,232,241.42857360839844,23804,Data as Reported to CDC as of 27 Feb 2024 2:00 PM EDT
09/08/2022,2022,233,227.57142639160156,24037,Data as Reported to CDC as of 27 Feb 2024 2:00 PM EDT
09/09/2022,2022,220,220,24257,Data as Reported to CDC as of 27 Feb 2024 2:00 PM EDT
09/10/2022,2022,178,216.57142639160156,24435,Data as Reported to CDC as of 27 Feb 2024 2:00 PM EDT
09/11/2022,2022,107,207.42857360839844,24542,Data as Reported to CDC as of 27 Feb 2024 2:00 PM EDT
09/12/2022,2022,250,208.2857208251953,24792,Data as Reported to CDC as of 27 Feb 2024 2:00 PM EDT
09/13/2022,2022,194,202,24986,Data as Reported to CDC as of 27 Feb 2024 2:00 PM EDT
09/14/2022,2022,172,193.42857360839844,25158,Data as Reported to CDC as of 27 Feb 2024 2:00 PM EDT
09/15/2022,2022,172,184.7142791748047,25330,Data as Reported to CDC as of 27 Feb 2024 2:00 PM EDT
09/16/2022,2022,180,179,25510,Data as Reported to CDC as of 27 Feb 2024 2:00 PM EDT
09/17/2022,2022,145,174.2857208251953,25655,Data as Reported to CDC as of 27 Feb 2024 2:00 PM EDT
09/18/2022,2022,120,176.14285278320312,25775,Data as Reported to CDC as of 27 Feb 2024 2:00 PM EDT
09/19/2022,2022,142,160.7142791748047,25917,Data as Reported to CDC as of 27 Feb 2024 2:00 PM EDT
09/20/2022,2022,158,155.57142639160156,26075,Data as Reported to CDC as of 27 Feb 2024 2:00 PM EDT
09/21/2022,2022,134,150.14285278320312,26209,Data as Reported to CDC as of 27 Feb 2024 2:00 PM EDT
09/22/2022,2022,132,144.42857360839844,26341,Data as Reported to CDC as of 27 Feb 2024 2:00 PM EDT
09/23/2022,2022,122,136.14285278320312,26463,Data as Reported to CDC as of 27 Feb 2024 2:00 PM EDT
09/24/2022,2022,87,127.85713958740234,26550,Data as Reported to CDC as of 27 Feb 2024 2:00 PM EDT
09/25/2022,2022,86,123,26636,Data as Reported to CDC as of 27 Feb 2024 2:00 PM EDT
09/26/2022,2022,149,124,26785,Data as Reported to CDC as of 27 Feb 2024 2:00 PM EDT
09/27/2022,2022,106,116.57142639160156,26891,Data as Reported to CDC as of 27 Feb 2024 2:00 PM EDT
09/28/2022,2022,103,112.14286041259766,26994,Data as Reported to CDC as of 27 Feb 2024 2:00 PM EDT
09/29/2022,2022,90,106.14286041259766,27084,Data as Reported to CDC as of 27 Feb 2024 2:00 PM EDT
09/30/2022,2022,106,103.85713958740234,27190,Data as Reported to CDC as of 27 Feb 2024 2:00 PM EDT
10/01/2022,2022,83,103.28571319580078,27273,Data as Reported to CDC as of 27 Feb 2024 2:00 PM EDT
10/02/2022,2022,63,100,27336,Data as Reported to CDC as of 27 Feb 2024 2:00 PM EDT
10/03/2022,2022,92,91.85713958740234,27428,Data as Reported to CDC as of 27 Feb 2024 2:00 PM EDT
10/04/2022,2022,85,88.85713958740234,27513,Data as Reported to CDC as of 27 Feb 2024 2:00 PM EDT
10/05/2022,2022,84,86.14286041259766,27597,Data as Reported to CDC as of 27 Feb 2024 2:00 PM EDT
10/06/2022,2022,97,87.14286041259766,27694,Data as Reported to CDC as of 27 Feb 2024 2:00 PM EDT
10/07/2022,2022,86,84.28571319580078,27780,Data as Reported to CDC as of 27 Feb 2024 2:00 PM EDT
10/08/2022,2022,54,80.14286041259766,27834,Data as Reported to CDC as of 27 Feb 2024 2:00 PM EDT
10/09/2022,2022,77,82.14286041259766,27911,Data as Reported to CDC as of 27 Feb 2024 2:00 PM EDT
10/10/2022,2022,84,81,27995,Data as Reported to CDC as of 27 Feb 2024 2:00 PM EDT
10/11/2022,2022,66,78.28571319580078,28061,Data as Reported to CDC as of 27 Feb 2024 2:00 PM EDT
10/12/2022,2022,71,76.42857360839844,28132,Data as Reported to CDC as of 27 Feb 2024 2:00 PM EDT
10/13/2022,2022,55,70.42857360839844,28187,Data as Reported to CDC as of 27 Feb 2024 2:00 PM EDT
10/14/2022,2022,72,68.42857360839844,28259,Data as Reported to CDC as of 27 Feb 2024 2:00 PM EDT
10/15/2022,2022,48,67.57142639160156,28307,Data as Reported to CDC as of 27 Feb 2024 2:00 PM EDT
10/16/2022,2022,49,63.57143020629883,28356,Data as Reported to CDC as of 27 Feb 2024 2:00 PM EDT
10/17/2022,2022,62,60.42856979370117,28418,Data as Reported to CDC as of 27 Feb 2024 2:00 PM EDT
10/18/2022,2022,55,58.85714340209961,28473,Data as Reported to CDC as of 27 Feb 2024 2:00 PM EDT
10/19/2022,2022,48,55.57143020629883,28521,Data as Reported to CDC as of 27 Feb 2024 2:00 PM EDT
10/20/2022,2022,60,56.28571319580078,28581,Data as Reported to CDC as of 27 Feb 2024 2:00 PM EDT
10/21/2022,2022,54,53.71428680419922,28635,Data as Reported to CDC as of 27 Feb 2024 2:00 PM EDT
10/22/2022,2022,36,52,28671,Data as Reported to CDC as of 27 Feb 2024 2:00 PM EDT
10/23/2022,2022,29,49.14285659790039,28700,Data as Reported to CDC as of 27 Feb 2024 2:00 PM EDT
10/24/2022,2022,53,47.85714340209961,28753,Data as Reported to CDC as of 27 Feb 2024 2:00 PM EDT
10/25/2022,2022,44,46.28571319580078,28797,Data as Reported to CDC as of 27 Feb 2024 2:00 PM EDT
10/26/2022,2022,53,47,28850,Data as Reported to CDC as of 27 Feb 2024 2:00 PM EDT
10/27/2022,2022,40,44.14285659790039,28890,Data as Reported to CDC as of 27 Feb 2024 2:00 PM EDT
10/28/2022,2022,38,41.85714340209961,28928,Data as Reported to CDC as of 27 Feb 2024 2:00 PM EDT
10/29/2022,2022,30,41,28958,Data as Reported to CDC as of 27 Feb 2024 2:00 PM EDT
10/30/2022,2022,27,40.71428680419922,28985,Data as Reported to CDC as of 27 Feb 2024 2:00 PM EDT
10/31/2022,2022,45,39.57143020629883,29030,Data as Reported to CDC as of 27 Feb 2024 2:00 PM EDT
11/01/2022,2022,41,39.14285659790039,29071,Data as Reported to CDC as of 27 Feb 2024 2:00 PM EDT
11/02/2022,2022,42,37.57143020629883,29113,Data as Reported to CDC as of 27 Feb 2024 2:00 PM EDT
11/03/2022,2022,33,36.57143020629883,29146,Data as Reported to CDC as of 27 Feb 2024 2:00 PM EDT
11/04/2022,2022,33,35.85714340209961,29179,Data as Reported to CDC as of 27 Feb 2024 2:00 PM EDT
11/05/2022,2022,32,36.14285659790039,29211,Data as Reported to CDC as of 27 Feb 2024 2:00 PM EDT
11/06/2022,2022,29,36.42856979370117,29240,Data as Reported to CDC as of 27 Feb 2024 2:00 PM EDT
11/07/2022,2022,44,36.28571319580078,29284,Data as Reported to CDC as of 27 Feb 2024 2:00 PM EDT
11/08/2022,2022,24,33.85714340209961,29308,Data as Reported to CDC as of 27 Feb 2024 2:00 PM EDT
11/09/2022,2022,30,32.14285659790039,29338,Data as Reported to CDC as of 27 Feb 2024 2:00 PM EDT
11/10/2022,2022,28,31.428571701049805,29366,Data as Reported to CDC as of 27 Feb 2024 2:00 PM EDT
11/11/2022,2022,32,31.285715103149414,29398,Data as Reported to CDC as of 27 Feb 2024 2:00 PM EDT
11/12/2022,2022,16,29,29414,Data as Reported to CDC as of 27 Feb 2024 2:00 PM EDT
11/13/2022,2022,23,28.14285659790039,29437,Data as Reported to CDC as of 27 Feb 2024 2:00 PM EDT
11/14/2022,2022,35,26.85714340209961,29472,Data as Reported to CDC as of 27 Feb 2024 2:00 PM EDT
11/15/2022,2022,18,26,29490,Data as Reported to CDC as of 27 Feb 2024 2:00 PM EDT
11/16/2022,2022,24,25.14285659790039,29514,Data as Reported to CDC as of 27 Feb 2024 2:00 PM EDT
11/17/2022,2022,13,23,29527,Data as Reported to CDC as of 27 Feb 2024 2:00 PM EDT
11/18/2022,2022,31,22.85714340209961,29558,Data as Reported to CDC as of 27 Feb 2024 2:00 PM EDT
11/19/2022,2022,20,23.428571701049805,29578,Data as Reported to CDC as of 27 Feb 2024 2:00 PM EDT
11/20/2022,2022,19,22.85714340209961,29597,Data as Reported to CDC as of 27 Feb 2024 2:00 PM EDT
11/21/2022,2022,25,21.428571701049805,29622,Data as Reported to CDC as of 27 Feb 2024 2:00 PM EDT
11/22/2022,2022,17,21.285715103149414,29639,Data as Reported to CDC as of 27 Feb 2024 2:00 PM EDT
11/23/2022,2022,18,20.428571701049805,29657,Data as Reported to CDC as of 27 Feb 2024 2:00 PM EDT
11/24/2022,2022,18,21.14285659790039,29675,Data as Reported to CDC as of 27 Feb 2024 2:00 PM EDT
11/25/2022,2022,14,18.714284896850586,29689,Data as Reported to CDC as of 27 Feb 2024 2:00 PM EDT
11/26/2022,2022,14,17.85714340209961,29703,Data as Reported to CDC as of 27 Feb 2024 2:00 PM EDT
11/27/2022,2022,8,16.285715103149414,29711,Data as Reported to CDC as of 27 Feb 2024 2:00 PM EDT
11/28/2022,2022,23,16,29734,Data as Reported to CDC as of 27 Feb 2024 2:00 PM EDT
11/29/2022,2022,17,16,29751,Data as Reported to CDC as of 27 Feb 2024 2:00 PM EDT
11/30/2022,2022,15,15.571428298950195,29766,Data as Reported to CDC as of 27 Feb 2024 2:00 PM EDT
12/01/2022,2022,20,15.857142448425293,29786,Data as Reported to CDC as of 27 Feb 2024 2:00 PM EDT
12/02/2022,2022,14,15.857142448425293,29800,Data as Reported to CDC as of 27 Feb 2024 2:00 PM EDT
12/03/2022,2022,8,15,29808,Data as Reported to CDC as of 27 Feb 2024 2:00 PM EDT
12/04/2022,2022,10,15.285714149475098,29818,Data as Reported to CDC as of 27 Feb 2024 2:00 PM EDT
12/05/2022,2022,21,15,29839,Data as Reported to CDC as of 27 Feb 2024 2:00 PM EDT
12/06/2022,2022,10,14,29849,Data as Reported to CDC as of 27 Feb 2024 2:00 PM EDT
12/07/2022,2022,14,13.857142448425293,29863,Data as Reported to CDC as of 27 Feb 2024 2:00 PM EDT
12/08/2022,2022,17,13.428571701049805,29880,Data as Reported to CDC as of 27 Feb 2024 2:00 PM EDT
12/09/2022,2022,13,13.285714149475098,29893,Data as Reported to CDC as of 27 Feb 2024 2:00 PM EDT
12/10/2022,2022,11,13.714285850524902,29904,Data as Reported to CDC as of 27 Feb 2024 2:00 PM EDT
12/11/2022,2022,8,13.428571701049805,29912,Data as Reported to CDC as of 27 Feb 2024 2:00 PM EDT
12/12/2022,2022,14,12.428571701049805,29926,Data as Reported to CDC as of 27 Feb 2024 2:00 PM EDT
12/13/2022,2022,12,12.714285850524902,29938,Data as Reported to CDC as of 27 Feb 2024 2:00 PM EDT
12/14/2022,2022,15,12.857142448425293,29953,Data as Reported to CDC as of 27 Feb 2024 2:00 PM EDT
12/15/2022,2022,15,12.571428298950195,29968,Data as Reported to CDC as of 27 Feb 2024 2:00 PM EDT
12/16/2022,2022,15,12.857142448425293,29983,Data as Reported to CDC as of 27 Feb 2024 2:00 PM EDT
12/17/2022,2022,9,12.571428298950195,29992,Data as Reported to CDC as of 27 Feb 2024 2:00 PM EDT
12/18/2022,2022,9,12.714285850524902,30001,Data as Reported to CDC as of 27 Feb 2024 2:00 PM EDT
12/19/2022,2022,16,13,30017,Data as Reported to CDC as of 27 Feb 2024 2:00 PM EDT
12/20/2022,2022,12,13,30029,Data as Reported to CDC as of 27 Feb 2024 2:00 PM EDT
12/21/2022,2022,2,11.142857551574707,30031,Data as Reported to CDC as of 27 Feb 2024 2:00 PM EDT
12/22/2022,2022,9,10.285714149475098,30040,Data as Reported to CDC as of 27 Feb 2024 2:00 PM EDT
12/23/2022,2022,8,9.285714149475098,30048,Data as Reported to CDC as of 27 Feb 2024 2:00 PM EDT
12/24/2022,2022,6,8.857142448425293,30054,Data as Reported to CDC as of 27 Feb 2024 2:00 PM EDT
12/25/2022,2022,7,8.571428298950195,30061,Data as Reported to CDC as of 27 Feb 2024 2:00 PM EDT
12/26/2022,2022,8,7.4285712242126465,30069,Data as Reported to CDC as of 27 Feb 2024 2:00 PM EDT
12/27/2022,2022,4,6.285714149475098,30073,Data as Reported to CDC as of 27 Feb 2024 2:00 PM EDT
12/28/2022,2022,6,6.857142925262451,30079,Data as Reported to CDC as of 27 Feb 2024 2:00 PM EDT
12/29/2022,2022,3,6,30082,Data as Reported to CDC as of 27 Feb 2024 2:00 PM EDT
12/30/2022,2022,5,5.5714287757873535,30087,Data as Reported to CDC as of 27 Feb 2024 2:00 PM EDT
12/31/2022,2022,5,5.4285712242126465,30092,Data as Reported to CDC as of 27 Feb 2024 2:00 PM EDT
01/01/2023,2023,12,6.142857074737549,30104,Data as Reported to CDC as of 27 Feb 2024 2:00 PM EDT
01/02/2023,2023,4,5.5714287757873535,30108,Data as Reported to CDC as of 27 Feb 2024 2:00 PM EDT
01/03/2023,2023,8,6.142857074737549,30116,Data as Reported to CDC as of 27 Feb 2024 2:00 PM EDT
01/04/2023,2023,3,5.714285850524902,30119,Data as Reported to CDC as of 27 Feb 2024 2:00 PM EDT
01/05/2023,2023,6,6.142857074737549,30125,Data as Reported to CDC as of 27 Feb 2024 2:00 PM EDT
01/06/2023,2023,6,6.285714149475098,30131,Data as Reported to CDC as of 27 Feb 2024 2:00 PM EDT
01/07/2023,2023,6,6.4285712242126465,30137,Data as Reported to CDC as of 27 Feb 2024 2:00 PM EDT
01/08/2023,2023,8,5.857142925262451,30145,Data as Reported to CDC as of 27 Feb 2024 2:00 PM EDT
01/09/2023,2023,7,6.285714149475098,30152,Data as Reported to CDC as of 27 Feb 2024 2:00 PM EDT
01/10/2023,2023,10,6.5714287757873535,30162,Data as Reported to CDC as of 27 Feb 2024 2:00 PM EDT
01/11/2023,2023,6,7,30168,Data as Reported to CDC as of 27 Feb 2024 2:00 PM EDT
01/12/2023,2023,6,7,30174,Data as Reported to CDC as of 27 Feb 2024 2:00 PM EDT
01/13/2023,2023,7,7.142857074737549,30181,Data as Reported to CDC as of 27 Feb 2024 2:00 PM EDT
01/14/2023,2023,6,7.142857074737549,30187,Data as Reported to CDC as of 27 Feb 2024 2:00 PM EDT
01/15/2023,2023,8,7.142857074737549,30195,Data as Reported to CDC as of 27 Feb 2024 2:00 PM EDT
01/16/2023,2023,4,6.714285850524902,30199,Data as Reported to CDC as of 27 Feb 2024 2:00 PM EDT
01/17/2023,2023,2,5.5714287757873535,30201,Data as Reported to CDC as of 27 Feb 2024 2:00 PM EDT
01/18/2023,2023,5,5.4285712242126465,30206,Data as Reported to CDC as of 27 Feb 2024 2:00 PM EDT
01/19/2023,2023,2,4.857142925262451,30208,Data as Reported to CDC as of 27 Feb 2024 2:00 PM EDT
01/20/2023,2023,11,5.4285712242126465,30219,Data as Reported to CDC as of 27 Feb 2024 2:00 PM EDT
01/21/2023,2023,5,5.285714149475098,30224,Data as Reported to CDC as of 27 Feb 2024 2:00 PM EDT
01/22/2023,2023,4,4.714285850524902,30228,Data as Reported to CDC as of 27 Feb 2024 2:00 PM EDT
01/23/2023,2023,3,4.5714287757873535,30231,Data as Reported to CDC as of 27 Feb 2024 2:00 PM EDT
01/24/2023,2023,5,5,30236,Data as Reported to CDC as of 27 Feb 2024 2:00 PM EDT
01/25/2023,2023,7,5.285714149475098,30243,Data as Reported to CDC as of 27 Feb 2024 2:00 PM EDT
01/26/2023,2023,3,5.4285712242126465,30246,Data as Reported to CDC as of 27 Feb 2024 2:00 PM EDT
01/27/2023,2023,5,4.5714287757873535,30251,Data as Reported to CDC as of 27 Feb 2024 2:00 PM EDT
01/28/2023,2023,4,4.4285712242126465,30255,Data as Reported to CDC as of 27 Feb 2024 2:00 PM EDT
01/29/2023,2023,3,4.285714149475098,30258,Data as Reported to CDC as of 27 Feb 2024 2:00 PM EDT
01/30/2023,2023,4,4.4285712242126465,30262,Data as Reported to CDC as of 27 Feb 2024 2:00 PM EDT
01/31/2023,2023,6,4.5714287757873535,30268,Data as Reported to CDC as of 27 Feb 2024 2:00 PM EDT
02/01/2023,2023,3,4,30271,Data as Reported to CDC as of 27 Feb 2024 2:00 PM EDT
02/02/2023,2023,5,4.285714149475098,30276,Data as Reported to CDC as of 27 Feb 2024 2:00 PM EDT
02/03/2023,2023,2,3.857142925262451,30278,Data as Reported to CDC as of 27 Feb 2024 2:00 PM EDT
02/04/2023,2023,4,3.857142925262451,30282,Data as Reported to CDC as of 27 Feb 2024 2:00 PM EDT
02/05/2023,2023,1,3.5714285373687744,30283,Data as Reported to CDC as of 27 Feb 2024 2:00 PM EDT
02/06/2023,2023,1,3.142857074737549,30284,Data as Reported to CDC as of 27 Feb 2024 2:00 PM EDT
02/07/2023,2023,2,2.5714285373687744,30286,Data as Reported to CDC as of 27 Feb 2024 2:00 PM EDT
02/08/2023,2023,2,2.4285714626312256,30288,Data as Reported to CDC as of 27 Feb 2024 2:00 PM EDT
02/09/2023,2023,2,2,30290,Data as Reported to CDC as of 27 Feb 2024 2:00 PM EDT
02/10/2023,2023,4,2.2857143878936768,30294,Data as Reported to CDC as of 27 Feb 2024 2:00 PM EDT
02/11/2023,2023,1,1.8571428060531616,30295,Data as Reported to CDC as of 27 Feb 2024 2:00 PM EDT
02/12/2023,2023,2,2,30297,Data as Reported to CDC as of 27 Feb 2024 2:00 PM EDT
02/13/2023,2023,1,2,30298,Data as Reported to CDC as of 27 Feb 2024 2:00 PM EDT
02/14/2023,2023,2,2,30300,Data as Reported to CDC as of 27 Feb 2024 2:00 PM EDT
02/15/2023,2023,2,2,30302,Data as Reported to CDC as of 27 Feb 2024 2:00 PM EDT
02/16/2023,2023,3,2.142857074737549,30305,Data as Reported to CDC as of 27 Feb 2024 2:00 PM EDT
02/17/2023,2023,3,2,30308,Data as Reported to CDC as of 27 Feb 2024 2:00 PM EDT
02/18/2023,2023,3,2.2857143878936768,30311,Data as Reported to CDC as of 27 Feb 2024 2:00 PM EDT
02/19/2023,2023,1,2.142857074737549,30312,Data as Reported to CDC as of 27 Feb 2024 2:00 PM EDT
02/20/2023,2023,2,2.2857143878936768,30314,Data as Reported to CDC as of 27 Feb 2024 2:00 PM EDT
02/21/2023,2023,0,2,30314,Data as Reported to CDC as of 27 Feb 2024 2:00 PM EDT
02/22/2023,2023,2,2,30316,Data as Reported to CDC as of 27 Feb 2024 2:00 PM EDT
02/23/2023,2023,2,1.8571428060531616,30318,Data as Reported to CDC as of 27 Feb 2024 2:00 PM EDT
02/24/2023,2023,2,1.7142857313156128,30320,Data as Reported to CDC as of 27 Feb 2024 2:00 PM EDT
02/25/2023,2023,1,1.4285714626312256,30321,Data as Reported to CDC as of 27 Feb 2024 2:00 PM EDT
02/26/2023,2023,4,1.8571428060531616,30325,Data as Reported to CDC as of 27 Feb 2024 2:00 PM EDT
02/27/2023,2023,3,2,30328,Data as Reported to CDC as of 27 Feb 2024 2:00 PM EDT
02/28/2023,2023,6,2.857142925262451,30334,Data as Reported to CDC as of 27 Feb 2024 2:00 PM EDT
03/01/2023,2023,2,2.857142925262451,30336,Data as Reported to CDC as of 27 Feb 2024 2:00 PM EDT
03/02/2023,2023,1,2.7142856121063232,30337,Data as Reported to CDC as of 27 Feb 2024 2:00 PM EDT
03/03/2023,2023,0,2.4285714626312256,30337,Data as Reported to CDC as of 27 Feb 2024 2:00 PM EDT
03/04/2023,2023,7,3.2857143878936768,30344,Data as Reported to CDC as of 27 Feb 2024 2:00 PM EDT
03/05/2023,2023,2,3,30346,Data as Reported to CDC as of 27 Feb 2024 2:00 PM EDT
03/06/2023,2023,0,2.5714285373687744,30346,Data as Reported to CDC as of 27 Feb 2024 2:00 PM EDT
03/07/2023,2023,1,1.8571428060531616,30347,Data as Reported to CDC as of 27 Feb 2024 2:00 PM EDT
03/08/2023,2023,2,1.8571428060531616,30349,Data as Reported to CDC as of 27 Feb 2024 2:00 PM EDT
03/09/2023,2023,2,2,30351,Data as Reported to CDC as of 27 Feb 2024 2:00 PM EDT
03/10/2023,2023,3,2.4285714626312256,30354,Data as Reported to CDC as of 27 Feb 2024 2:00 PM EDT
03/11/2023,2023,3,1.8571428060531616,30357,Data as Reported to CDC as of 27 Feb 2024 2:00 PM EDT
03/12/2023,2023,0,1.5714285373687744,30357,Data as Reported to CDC as of 27 Feb 2024 2:00 PM EDT
03/13/2023,2023,5,2.2857143878936768,30362,Data as Reported to CDC as of 27 Feb 2024 2:00 PM EDT
03/14/2023,2023,2,2.4285714626312256,30364,Data as Reported to CDC as of 27 Feb 2024 2:00 PM EDT
03/15/2023,2023,0,2.142857074737549,30364,Data as Reported to CDC as of 27 Feb 2024 2:00 PM EDT
03/16/2023,2023,2,2.142857074737549,30366,Data as Reported to CDC as of 27 Feb 2024 2:00 PM EDT
03/17/2023,2023,2,2,30368,Data as Reported to CDC as of 27 Feb 2024 2:00 PM EDT
03/18/2023,2023,1,1.7142857313156128,30369,Data as Reported to CDC as of 27 Feb 2024 2:00 PM EDT
03/19/2023,2023,1,1.8571428060531616,30370,Data as Reported to CDC as of 27 Feb 2024 2:00 PM EDT
03/20/2023,2023,1,1.2857142686843872,30371,Data as Reported to CDC as of 27 Feb 2024 2:00 PM EDT
03/21/2023,2023,2,1.2857142686843872,30373,Data as Reported to CDC as of 27 Feb 2024 2:00 PM EDT
03/22/2023,2023,0,1.2857142686843872,30373,Data as Reported to CDC as of 27 Feb 2024 2:00 PM EDT
03/23/2023,2023,2,1.2857142686843872,30375,Data as Reported to CDC as of 27 Feb 2024 2:00 PM EDT
03/24/2023,2023,3,1.4285714626312256,30378,Data as Reported to CDC as of 27 Feb 2024 2:00 PM EDT
03/25/2023,2023,1,1.4285714626312256,30379,Data as Reported to CDC as of 27 Feb 2024 2:00 PM EDT
03/26/2023,2023,2,1.5714285373687744,30381,Data as Reported to CDC as of 27 Feb 2024 2:00 PM EDT
03/27/2023,2023,3,1.8571428060531616,30384,Data as Reported to CDC as of 27 Feb 2024 2:00 PM EDT
03/28/2023,2023,0,1.5714285373687744,30384,Data as Reported to CDC as of 27 Feb 2024 2:00 PM EDT
03/29/2023,2023,2,1.8571428060531616,30386,Data as Reported to CDC as of 27 Feb 2024 2:00 PM EDT
03/30/2023,2023,3,2,30389,Data as Reported to CDC as of 27 Feb 2024 2:00 PM EDT
03/31/2023,2023,2,1.8571428060531616,30391,Data as Reported to CDC as of 27 Feb 2024 2:00 PM EDT
04/01/2023,2023,2,2,30393,Data as Reported to CDC as of 27 Feb 2024 2:00 PM EDT
04/02/2023,2023,0,1.7142857313156128,30393,Data as Reported to CDC as of 27 Feb 2024 2:00 PM EDT
04/03/2023,2023,3,1.7142857313156128,30396,Data as Reported to CDC as of 27 Feb 2024 2:00 PM EDT
04/04/2023,2023,0,1.7142857313156128,30396,Data as Reported to CDC as of 27 Feb 2024 2:00 PM EDT
04/05/2023,2023,2,1.7142857313156128,30398,Data as Reported to CDC as of 27 Feb 2024 2:00 PM EDT
04/06/2023,2023,2,1.5714285373687744,30400,Data as Reported to CDC as of 27 Feb 2024 2:00 PM EDT
04/07/2023,2023,1,1.4285714626312256,30401,Data as Reported to CDC as of 27 Feb 2024 2:00 PM EDT
04/08/2023,2023,0,1.1428571939468384,30401,Data as Reported to CDC as of 27 Feb 2024 2:00 PM EDT
04/09/2023,2023,0,1.1428571939468384,30401,Data as Reported to CDC as of 27 Feb 2024 2:00 PM EDT
04/10/2023,2023,0,0.7142857313156128,30401,Data as Reported to CDC as of 27 Feb 2024 2:00 PM EDT
04/11/2023,2023,0,0.7142857313156128,30401,Data as Reported to CDC as of 27 Feb 2024 2:00 PM EDT
04/12/2023,2023,3,0.8571428656578064,30404,Data as Reported to CDC as of 27 Feb 2024 2:00 PM EDT
04/13/2023,2023,2,0.8571428656578064,30406,Data as Reported to CDC as of 27 Feb 2024 2:00 PM EDT
04/14/2023,2023,2,1,30408,Data as Reported to CDC as of 27 Feb 2024 2:00 PM EDT
04/15/2023,2023,3,1.4285714626312256,30411,Data as Reported to CDC as of 27 Feb 2024 2:00 PM EDT
04/16/2023,2023,3,1.8571428060531616,30414,Data as Reported to CDC as of 27 Feb 2024 2:00 PM EDT
04/17/2023,2023,1,2,30415,Data as Reported to CDC as of 27 Feb 2024 2:00 PM EDT
04/18/2023,2023,4,2.5714285373687744,30419,Data as Reported to CDC as of 27 Feb 2024 2:00 PM EDT
04/19/2023,2023,2,2.4285714626312256,30421,Data as Reported to CDC as of 27 Feb 2024 2:00 PM EDT
04/20/2023,2023,4,2.7142856121063232,30425,Data as Reported to CDC as of 27 Feb 2024 2:00 PM EDT
04/21/2023,2023,2,2.7142856121063232,30427,Data as Reported to CDC as of 27 Feb 2024 2:00 PM EDT
04/22/2023,2023,0,2.2857143878936768,30427,Data as Reported to CDC as of 27 Feb 2024 2:00 PM EDT
04/23/2023,2023,3,2.2857143878936768,30430,Data as Reported to CDC as of 27 Feb 2024 2:00 PM EDT
04/24/2023,2023,1,2.2857143878936768,30431,Data as Reported to CDC as of 27 Feb 2024 2:00 PM EDT
04/25/2023,2023,1,1.8571428060531616,30432,Data as Reported to CDC as of 27 Feb 2024 2:00 PM EDT
04/26/2023,2023,0,1.5714285373687744,30432,Data as Reported to CDC as of 27 Feb 2024 2:00 PM EDT
04/27/2023,2023,1,1.1428571939468384,30433,Data as Reported to CDC as of 27 Feb 2024 2:00 PM EDT
04/28/2023,2023,1,1,30434,Data as Reported to CDC as of 27 Feb 2024 2:00 PM EDT
04/29/2023,2023,2,1.2857142686843872,30436,Data as Reported to CDC as of 27 Feb 2024 2:00 PM EDT
04/30/2023,2023,1,1,30437,Data as Reported to CDC as of 27 Feb 2024 2:00 PM EDT
05/01/2023,2023,7,1.8571428060531616,30444,Data as Reported to CDC as of 27 Feb 2024 2:00 PM EDT
05/02/2023,2023,2,2,30446,Data as Reported to CDC as of 27 Feb 2024 2:00 PM EDT
05/03/2023,2023,5,2.7142856121063232,30451,Data as Reported to CDC as of 27 Feb 2024 2:00 PM EDT
05/04/2023,2023,5,3.2857143878936768,30456,Data as Reported to CDC as of 27 Feb 2024 2:00 PM EDT
05/05/2023,2023,2,3.4285714626312256,30458,Data as Reported to CDC as of 27 Feb 2024 2:00 PM EDT
05/06/2023,2023,2,3.4285714626312256,30460,Data as Reported to CDC as of 27 Feb 2024 2:00 PM EDT
05/07/2023,2023,4,3.857142925262451,30464,Data as Reported to CDC as of 27 Feb 2024 2:00 PM EDT
05/08/2023,2023,1,3,30465,Data as Reported to CDC as of 27 Feb 2024 2:00 PM EDT
05/09/2023,2023,4,3.2857143878936768,30469,Data as Reported to CDC as of 27 Feb 2024 2:00 PM EDT
05/10/2023,2023,1,2.7142856121063232,30470,Data as Reported to CDC as of 27 Feb 2024 2:00 PM EDT
05/11/2023,2023,3,2.4285714626312256,30473,Data as Reported to CDC as of 27 Feb 2024 2:00 PM EDT
05/12/2023,2023,0,2.142857074737549,30473,Data as Reported to CDC as of 27 Feb 2024 2:00 PM EDT
05/13/2023,2023,5,2.5714285373687744,30478,Data as Reported to CDC as of 27 Feb 2024 2:00 PM EDT
05/14/2023,2023,1,2.142857074737549,30479,Data as Reported to CDC as of 27 Feb 2024 2:00 PM EDT
05/15/2023,2023,5,2.7142856121063232,30484,Data as Reported to CDC as of 27 Feb 2024 2:00 PM EDT
05/16/2023,2023,3,2.5714285373687744,30487,Data as Reported to CDC as of 27 Feb 2024 2:00 PM EDT
05/17/2023,2023,2,2.7142856121063232,30489,Data as Reported to CDC as of 27 Feb 2024 2:00 PM EDT
05/18/2023,2023,4,2.857142925262451,30493,Data as Reported to CDC as of 27 Feb 2024 2:00 PM EDT
05/19/2023,2023,2,3.142857074737549,30495,Data as Reported to CDC as of 27 Feb 2024 2:00 PM EDT
05/20/2023,2023,2,2.7142856121063232,30497,Data as Reported to CDC as of 27 Feb 2024 2:00 PM EDT
05/21/2023,2023,0,2.5714285373687744,30497,Data as Reported to CDC as of 27 Feb 2024 2:00 PM EDT
05/22/2023,2023,3,2.2857143878936768,30500,Data as Reported to CDC as of 27 Feb 2024 2:00 PM EDT
05/23/2023,2023,2,2.142857074737549,30502,Data as Reported to CDC as of 27 Feb 2024 2:00 PM EDT
05/24/2023,2023,5,2.5714285373687744,30507,Data as Reported to CDC as of 27 Feb 2024 2:00 PM EDT
05/25/2023,2023,4,2.5714285373687744,30511,Data as Reported to CDC as of 27 Feb 2024 2:00 PM EDT
05/26/2023,2023,4,2.857142925262451,30515,Data as Reported to CDC as of 27 Feb 2024 2:00 PM EDT
05/27/2023,2023,3,3,30518,Data as Reported to CDC as of 27 Feb 2024 2:00 PM EDT
05/28/2023,2023,6,3.857142925262451,30524,Data as Reported to CDC as of 27 Feb 2024 2:00 PM EDT
05/29/2023,2023,2,3.7142856121063232,30526,Data as Reported to CDC as of 27 Feb 2024 2:00 PM EDT
05/30/2023,2023,2,3.7142856121063232,30528,Data as Reported to CDC as of 27 Feb 2024 2:00 PM EDT
05/31/2023,2023,1,3.142857074737549,30529,Data as Reported to CDC as of 27 Feb 2024 2:00 PM EDT
06/01/2023,2023,2,2.857142925262451,30531,Data as Reported to CDC as of 27 Feb 2024 2:00 PM EDT
06/02/2023,2023,5,3,30536,Data as Reported to CDC as of 27 Feb 2024 2:00 PM EDT
06/03/2023,2023,2,2.857142925262451,30538,Data as Reported to CDC as of 27 Feb 2024 2:00 PM EDT
06/04/2023,2023,4,2.5714285373687744,30542,Data as Reported to CDC as of 27 Feb 2024 2:00 PM EDT
06/05/2023,2023,6,3.142857074737549,30548,Data as Reported to CDC as of 27 Feb 2024 2:00 PM EDT
06/06/2023,2023,3,3.2857143878936768,30551,Data as Reported to CDC as of 27 Feb 2024 2:00 PM EDT
06/07/2023,2023,2,3.4285714626312256,30553,Data as Reported to CDC as of 27 Feb 2024 2:00 PM EDT
06/08/2023,2023,3,3.5714285373687744,30556,Data as Reported to CDC as of 27 Feb 2024 2:00 PM EDT
06/09/2023,2023,4,3.4285714626312256,30560,Data as Reported to CDC as of 27 Feb 2024 2:00 PM EDT
06/10/2023,2023,3,3.5714285373687744,30563,Data as Reported to CDC as of 27 Feb 2024 2:00 PM EDT
06/11/2023,2023,4,3.5714285373687744,30567,Data as Reported to CDC as of 27 Feb 2024 2:00 PM EDT
06/12/2023,2023,2,3,30569,Data as Reported to CDC as of 27 Feb 2024 2:00 PM EDT
06/13/2023,2023,5,3.2857143878936768,30574,Data as Reported to CDC as of 27 Feb 2024 2:00 PM EDT
06/14/2023,2023,5,3.7142856121063232,30579,Data as Reported to CDC as of 27 Feb 2024 2:00 PM EDT
06/15/2023,2023,3,3.7142856121063232,30582,Data as Reported to CDC as of 27 Feb 2024 2:00 PM EDT
06/16/2023,2023,5,3.857142925262451,30587,Data as Reported to CDC as of 27 Feb 2024 2:00 PM EDT
06/17/2023,2023,3,3.857142925262451,30590,Data as Reported to CDC as of 27 Feb 2024 2:00 PM EDT
06/18/2023,2023,6,4.142857074737549,30596,Data as Reported to CDC as of 27 Feb 2024 2:00 PM EDT
06/19/2023,2023,6,4.714285850524902,30602,Data as Reported to CDC as of 27 Feb 2024 2:00 PM EDT
06/20/2023,2023,3,4.4285712242126465,30605,Data as Reported to CDC as of 27 Feb 2024 2:00 PM EDT
06/21/2023,2023,4,4.285714149475098,30609,Data as Reported to CDC as of 27 Feb 2024 2:00 PM EDT
06/22/2023,2023,4,4.4285712242126465,30613,Data as Reported to CDC as of 27 Feb 2024 2:00 PM EDT
06/23/2023,2023,3,4.142857074737549,30616,Data as Reported to CDC as of 27 Feb 2024 2:00 PM EDT
06/24/2023,2023,1,3.857142925262451,30617,Data as Reported to CDC as of 27 Feb 2024 2:00 PM EDT
06/25/2023,2023,3,3.4285714626312256,30620,Data as Reported to CDC as of 27 Feb 2024 2:00 PM EDT
06/26/2023,2023,5,3.2857143878936768,30625,Data as Reported to CDC as of 27 Feb 2024 2:00 PM EDT
06/27/2023,2023,5,3.5714285373687744,30630,Data as Reported to CDC as of 27 Feb 2024 2:00 PM EDT
06/28/2023,2023,6,3.857142925262451,30636,Data as Reported to CDC as of 27 Feb 2024 2:00 PM EDT
06/29/2023,2023,5,4,30641,Data as Reported to CDC as of 27 Feb 2024 2:00 PM EDT
06/30/2023,2023,3,4,30644,Data as Reported to CDC as of 27 Feb 2024 2:00 PM EDT
07/01/2023,2023,2,4.142857074737549,30646,Data as Reported to CDC as of 27 Feb 2024 2:00 PM EDT
07/02/2023,2023,5,4.4285712242126465,30651,Data as Reported to CDC as of 27 Feb 2024 2:00 PM EDT
07/03/2023,2023,4,4.285714149475098,30655,Data as Reported to CDC as of 27 Feb 2024 2:00 PM EDT
07/04/2023,2023,3,4,30658,Data as Reported to CDC as of 27 Feb 2024 2:00 PM EDT
07/05/2023,2023,2,3.4285714626312256,30660,Data as Reported to CDC as of 27 Feb 2024 2:00 PM EDT
07/06/2023,2023,7,3.7142856121063232,30667,Data as Reported to CDC as of 27 Feb 2024 2:00 PM EDT
07/07/2023,2023,7,4.285714149475098,30674,Data as Reported to CDC as of 27 Feb 2024 2:00 PM EDT
07/08/2023,2023,5,4.714285850524902,30679,Data as Reported to CDC as of 27 Feb 2024 2:00 PM EDT
07/09/2023,2023,4,4.5714287757873535,30683,Data as Reported to CDC as of 27 Feb 2024 2:00 PM EDT
07/10/2023,2023,7,5,30690,Data as Reported to CDC as of 27 Feb 2024 2:00 PM EDT
07/11/2023,2023,5,5.285714149475098,30695,Data as Reported to CDC as of 27 Feb 2024 2:00 PM EDT
07/12/2023,2023,4,5.5714287757873535,30699,Data as Reported to CDC as of 27 Feb 2024 2:00 PM EDT
07/13/2023,2023,3,5,30702,Data as Reported to CDC as of 27 Feb 2024 2:00 PM EDT
07/14/2023,2023,6,4.857142925262451,30708,Data as Reported to CDC as of 27 Feb 2024 2:00 PM EDT
07/15/2023,2023,6,5,30714,Data as Reported to CDC as of 27 Feb 2024 2:00 PM EDT
07/16/2023,2023,2,4.714285850524902,30716,Data as Reported to CDC as of 27 Feb 2024 2:00 PM EDT
07/17/2023,2023,2,4,30718,Data as Reported to CDC as of 27 Feb 2024 2:00 PM EDT
07/18/2023,2023,3,3.7142856121063232,30721,Data as Reported to CDC as of 27 Feb 2024 2:00 PM EDT
07/19/2023,2023,9,4.4285712242126465,30730,Data as Reported to CDC as of 27 Feb 2024 2:00 PM EDT
07/20/2023,2023,2,4.285714149475098,30732,Data as Reported to CDC as of 27 Feb 2024 2:00 PM EDT
07/21/2023,2023,0,3.4285714626312256,30732,Data as Reported to CDC as of 27 Feb 2024 2:00 PM EDT
07/22/2023,2023,2,2.857142925262451,30734,Data as Reported to CDC as of 27 Feb 2024 2:00 PM EDT
07/23/2023,2023,1,2.7142856121063232,30735,Data as Reported to CDC as of 27 Feb 2024 2:00 PM EDT
07/24/2023,2023,5,3.142857074737549,30740,Data as Reported to CDC as of 27 Feb 2024 2:00 PM EDT
07/25/2023,2023,6,3.5714285373687744,30746,Data as Reported to CDC as of 27 Feb 2024 2:00 PM EDT
07/26/2023,2023,4,2.857142925262451,30750,Data as Reported to CDC as of 27 Feb 2024 2:00 PM EDT
07/27/2023,2023,4,3.142857074737549,30754,Data as Reported to CDC as of 27 Feb 2024 2:00 PM EDT
07/28/2023,2023,2,3.4285714626312256,30756,Data as Reported to CDC as of 27 Feb 2024 2:00 PM EDT
07/29/2023,2023,1,3.2857143878936768,30757,Data as Reported to CDC as of 27 Feb 2024 2:00 PM EDT
07/30/2023,2023,0,3.142857074737549,30757,Data as Reported to CDC as of 27 Feb 2024 2:00 PM EDT
07/31/2023,2023,5,3.142857074737549,30762,Data as Reported to CDC as of 27 Feb 2024 2:00 PM EDT
08/01/2023,2023,5,3,30767,Data as Reported to CDC as of 27 Feb 2024 2:00 PM EDT
08/02/2023,2023,6,3.2857143878936768,30773,Data as Reported to CDC as of 27 Feb 2024 2:00 PM EDT
08/03/2023,2023,3,3.142857074737549,30776,Data as Reported to CDC as of 27 Feb 2024 2:00 PM EDT
08/04/2023,2023,4,3.4285714626312256,30780,Data as Reported to CDC as of 27 Feb 2024 2:00 PM EDT
08/05/2023,2023,3,3.7142856121063232,30783,Data as Reported to CDC as of 27 Feb 2024 2:00 PM EDT
08/06/2023,2023,2,4,30785,Data as Reported to CDC as of 27 Feb 2024 2:00 PM EDT
08/07/2023,2023,4,3.857142925262451,30789,Data as Reported to CDC as of 27 Feb 2024 2:00 PM EDT
08/08/2023,2023,5,3.857142925262451,30794,Data as Reported to CDC as of 27 Feb 2024 2:00 PM EDT
08/09/2023,2023,5,3.7142856121063232,30799,Data as Reported to CDC as of 27 Feb 2024 2:00 PM EDT
08/10/2023,2023,2,3.5714285373687744,30801,Data as Reported to CDC as of 27 Feb 2024 2:00 PM EDT
08/11/2023,2023,3,3.4285714626312256,30804,Data as Reported to CDC as of 27 Feb 2024 2:00 PM EDT
08/12/2023,2023,3,3.4285714626312256,30807,Data as Reported to CDC as of 27 Feb 2024 2:00 PM EDT
08/13/2023,2023,3,3.5714285373687744,30810,Data as Reported to CDC as of 27 Feb 2024 2:00 PM EDT
08/14/2023,2023,3,3.4285714626312256,30813,Data as Reported to CDC as of 27 Feb 2024 2:00 PM EDT
08/15/2023,2023,5,3.4285714626312256,30818,Data as Reported to CDC as of 27 Feb 2024 2:00 PM EDT
08/16/2023,2023,6,3.5714285373687744,30824,Data as Reported to CDC as of 27 Feb 2024 2:00 PM EDT
08/17/2023,2023,1,3.4285714626312256,30825,Data as Reported to CDC as of 27 Feb 2024 2:00 PM EDT
08/18/2023,2023,2,3.2857143878936768,30827,Data as Reported to CDC as of 27 Feb 2024 2:00 PM EDT
08/19/2023,2023,1,3,30828,Data as Reported to CDC as of 27 Feb 2024 2:00 PM EDT
08/20/2023,2023,0,2.5714285373687744,30828,Data as Reported to CDC as of 27 Feb 2024 2:00 PM EDT
08/21/2023,2023,4,2.7142856121063232,30832,Data as Reported to CDC as of 27 Feb 2024 2:00 PM EDT
08/22/2023,2023,3,2.4285714626312256,30835,Data as Reported to CDC as of 27 Feb 2024 2:00 PM EDT
08/23/2023,2023,6,2.4285714626312256,30841,Data as Reported to CDC as of 27 Feb 2024 2:00 PM EDT
08/24/2023,2023,5,3,30846,Data as Reported to CDC as of 27 Feb 2024 2:00 PM EDT
08/25/2023,2023,3,3.142857074737549,30849,Data as Reported to CDC as of 27 Feb 2024 2:00 PM EDT
08/26/2023,2023,1,3.142857074737549,30850,Data as Reported to CDC as of 27 Feb 2024 2:00 PM EDT
08/27/2023,2023,3,3.5714285373687744,30853,Data as Reported to CDC as of 27 Feb 2024 2:00 PM EDT
08/28/2023,2023,2,3.2857143878936768,30855,Data as Reported to CDC as of 27 Feb 2024 2:00 PM EDT
08/29/2023,2023,4,3.4285714626312256,30859,Data as Reported to CDC as of 27 Feb 2024 2:00 PM EDT
08/30/2023,2023,2,2.857142925262451,30861,Data as Reported to CDC as of 27 Feb 2024 2:00 PM EDT
08/31/2023,2023,1,2.2857143878936768,30862,Data as Reported to CDC as of 27 Feb 2024 2:00 PM EDT
09/01/2023,2023,2,2.142857074737549,30864,Data as Reported to CDC as of 27 Feb 2024 2:00 PM EDT
09/02/2023,2023,1,2.142857074737549,30865,Data as Reported to CDC as of 27 Feb 2024 2:00 PM EDT
09/03/2023,2023,2,2,30867,Data as Reported to CDC as of 27 Feb 2024 2:00 PM EDT
09/04/2023,2023,4,2.2857143878936768,30871,Data as Reported to CDC as of 27 Feb 2024 2:00 PM EDT
09/05/2023,2023,5,2.4285714626312256,30876,Data as Reported to CDC as of 27 Feb 2024 2:00 PM EDT
09/06/2023,2023,4,2.7142856121063232,30880,Data as Reported to CDC as of 27 Feb 2024 2:00 PM EDT
09/07/2023,2023,0,2.5714285373687744,30880,Data as Reported to CDC as of 27 Feb 2024 2:00 PM EDT
09/08/2023,2023,4,2.857142925262451,30884,Data as Reported to CDC as of 27 Feb 2024 2:00 PM EDT
09/09/2023,2023,6,3.5714285373687744,30890,Data as Reported to CDC as of 27 Feb 2024 2:00 PM EDT
09/10/2023,2023,8,4.4285712242126465,30898,Data as Reported to CDC as of 27 Feb 2024 2:00 PM EDT
09/11/2023,2023,3,4.285714149475098,30901,Data as Reported to CDC as of 27 Feb 2024 2:00 PM EDT
09/12/2023,2023,6,4.4285712242126465,30907,Data as Reported to CDC as of 27 Feb 2024 2:00 PM EDT
09/13/2023,2023,2,4.142857074737549,30909,Data as Reported to CDC as of 27 Feb 2024 2:00 PM EDT
09/14/2023,2023,5,4.857142925262451,30914,Data as Reported to CDC as of 27 Feb 2024 2:00 PM EDT
09/15/2023,2023,9,5.5714287757873535,30923,Data as Reported to CDC as of 27 Feb 2024 2:00 PM EDT
09/16/2023,2023,3,5.142857074737549,30926,Data as Reported to CDC as of 27 Feb 2024 2:00 PM EDT
09/17/2023,2023,3,4.4285712242126465,30929,Data as Reported to CDC as of 27 Feb 2024 2:00 PM EDT
09/18/2023,2023,7,5,30936,Data as Reported to CDC as of 27 Feb 2024 2:00 PM EDT
09/19/2023,2023,5,4.857142925262451,30941,Data as Reported to CDC as of 27 Feb 2024 2:00 PM EDT
09/20/2023,2023,5,5.285714149475098,30946,Data as Reported to CDC as of 27 Feb 2024 2:00 PM EDT
09/21/2023,2023,6,5.4285712242126465,30952,Data as Reported to CDC as of 27 Feb 2024 2:00 PM EDT
09/22/2023,2023,7,5.142857074737549,30959,Data as Reported to CDC as of 27 Feb 2024 2:00 PM EDT
09/23/2023,2023,5,5.4285712242126465,30964,Data as Reported to CDC as of 27 Feb 2024 2:00 PM EDT
09/24/2023,2023,3,5.4285712242126465,30967,Data as Reported to CDC as of 27 Feb 2024 2:00 PM EDT
09/25/2023,2023,6,5.285714149475098,30973,Data as Reported to CDC as of 27 Feb 2024 2:00 PM EDT
09/26/2023,2023,6,5.4285712242126465,30979,Data as Reported to CDC as of 27 Feb 2024 2:00 PM EDT
09/27/2023,2023,2,5,30981,Data as Reported to CDC as of 27 Feb 2024 2:00 PM EDT
09/28/2023,2023,9,5.4285712242126465,30990,Data as Reported to CDC as of 27 Feb 2024 2:00 PM EDT
09/29/2023,2023,4,5,30994,Data as Reported to CDC as of 27 Feb 2024 2:00 PM EDT
09/30/2023,2023,5,5,30999,Data as Reported to CDC as of 27 Feb 2024 2:00 PM EDT
10/01/2023,2023,3,5,31002,Data as Reported to CDC as of 27 Feb 2024 2:00 PM EDT
10/02/2023,2023,7,5.142857074737549,31009,Data as Reported to CDC as of 27 Feb 2024 2:00 PM EDT
10/03/2023,2023,5,5,31014,Data as Reported to CDC as of 27 Feb 2024 2:00 PM EDT
10/04/2023,2023,5,5.4285712242126465,31019,Data as Reported to CDC as of 27 Feb 2024 2:00 PM EDT
10/05/2023,2023,14,6.142857074737549,31033,Data as Reported to CDC as of 27 Feb 2024 2:00 PM EDT
10/06/2023,2023,6,6.4285712242126465,31039,Data as Reported to CDC as of 27 Feb 2024 2:00 PM EDT
10/07/2023,2023,9,7,31048,Data as Reported to CDC as of 27 Feb 2024 2:00 PM EDT
10/08/2023,2023,8,7.714285850524902,31056,Data as Reported to CDC as of 27 Feb 2024 2:00 PM EDT
10/09/2023,2023,6,7.5714287757873535,31062,Data as Reported to CDC as of 27 Feb 2024 2:00 PM EDT
10/10/2023,2023,6,7.714285850524902,31068,Data as Reported to CDC as of 27 Feb 2024 2:00 PM EDT
10/11/2023,2023,7,8,31075,Data as Reported to CDC as of 27 Feb 2024 2:00 PM EDT
10/12/2023,2023,11,7.5714287757873535,31086,Data as Reported to CDC as of 27 Feb 2024 2:00 PM EDT
10/13/2023,2023,18,9.285714149475098,31104,Data as Reported to CDC as of 27 Feb 2024 2:00 PM EDT
10/14/2023,2023,7,9,31111,Data as Reported to CDC as of 27 Feb 2024 2:00 PM EDT
10/15/2023,2023,8,9,31119,Data as Reported to CDC as of 27 Feb 2024 2:00 PM EDT
10/16/2023,2023,11,9.714285850524902,31130,Data as Reported to CDC as of 27 Feb 2024 2:00 PM EDT
10/17/2023,2023,9,10.142857551574707,31139,Data as Reported to CDC as of 27 Feb 2024 2:00 PM EDT
10/18/2023,2023,2,9.428571701049805,31141,Data as Reported to CDC as of 27 Feb 2024 2:00 PM EDT
10/19/2023,2023,10,9.285714149475098,31151,Data as Reported to CDC as of 27 Feb 2024 2:00 PM EDT
10/20/2023,2023,13,8.571428298950195,31164,Data as Reported to CDC as of 27 Feb 2024 2:00 PM EDT
10/21/2023,2023,12,9.285714149475098,31176,Data as Reported to CDC as of 27 Feb 2024 2:00 PM EDT
10/22/2023,2023,4,8.714285850524902,31180,Data as Reported to CDC as of 27 Feb 2024 2:00 PM EDT
10/23/2023,2023,9,8.428571701049805,31189,Data as Reported to CDC as of 27 Feb 2024 2:00 PM EDT
10/24/2023,2023,10,8.571428298950195,31199,Data as Reported to CDC as of 27 Feb 2024 2:00 PM EDT
10/25/2023,2023,9,9.571428298950195,31208,Data as Reported to CDC as of 27 Feb 2024 2:00 PM EDT
10/26/2023,2023,13,10,31221,Data as Reported to CDC as of 27 Feb 2024 2:00 PM EDT
10/27/2023,2023,11,9.714285850524902,31232,Data as Reported to CDC as of 27 Feb 2024 2:00 PM EDT
10/28/2023,2023,5,8.714285850524902,31237,Data as Reported to CDC as of 27 Feb 2024 2:00 PM EDT
10/29/2023,2023,7,9.142857551574707,31244,Data as Reported to CDC as of 27 Feb 2024 2:00 PM EDT
10/30/2023,2023,8,9,31252,Data as Reported to CDC as of 27 Feb 2024 2:00 PM EDT
10/31/2023,2023,6,8.428571701049805,31258,Data as Reported to CDC as of 27 Feb 2024 2:00 PM EDT
11/01/2023,2023,7,8.142857551574707,31265,Data as Reported to CDC as of 27 Feb 2024 2:00 PM EDT
11/02/2023,2023,6,7.142857074737549,31271,Data as Reported to CDC as of 27 Feb 2024 2:00 PM EDT
11/03/2023,2023,9,6.857142925262451,31280,Data as Reported to CDC as of 27 Feb 2024 2:00 PM EDT
11/04/2023,2023,9,7.4285712242126465,31289,Data as Reported to CDC as of 27 Feb 2024 2:00 PM EDT
11/05/2023,2023,4,7,31293,Data as Reported to CDC as of 27 Feb 2024 2:00 PM EDT
11/06/2023,2023,15,8,31308,Data as Reported to CDC as of 27 Feb 2024 2:00 PM EDT
11/07/2023,2023,10,8.571428298950195,31318,Data as Reported to CDC as of 27 Feb 2024 2:00 PM EDT
11/08/2023,2023,11,9.142857551574707,31329,Data as Reported to CDC as of 27 Feb 2024 2:00 PM EDT
11/09/2023,2023,16,10.571428298950195,31345,Data as Reported to CDC as of 27 Feb 2024 2:00 PM EDT
11/10/2023,2023,5,10,31350,Data as Reported to CDC as of 27 Feb 2024 2:00 PM EDT
11/11/2023,2023,8,9.857142448425293,31358,Data as Reported to CDC as of 27 Feb 2024 2:00 PM EDT
11/12/2023,2023,9,10.571428298950195,31367,Data as Reported to CDC as of 27 Feb 2024 2:00 PM EDT
11/13/2023,2023,11,10,31378,Data as Reported to CDC as of 27 Feb 2024 2:00 PM EDT
11/14/2023,2023,12,10.285714149475098,31390,Data as Reported to CDC as of 27 Feb 2024 2:00 PM EDT
11/15/2023,2023,10,10.142857551574707,31400,Data as Reported to CDC as of 27 Feb 2024 2:00 PM EDT
11/16/2023,2023,11,9.428571701049805,31411,Data as Reported to CDC as of 27 Feb 2024 2:00 PM EDT
11/17/2023,2023,8,9.857142448425293,31419,Data as Reported to CDC as of 27 Feb 2024 2:00 PM EDT
11/18/2023,2023,8,9.857142448425293,31427,Data as Reported to CDC as of 27 Feb 2024 2:00 PM EDT
11/19/2023,2023,7,9.571428298950195,31434,Data as Reported to CDC as of 27 Feb 2024 2:00 PM EDT
11/20/2023,2023,8,9.142857551574707,31442,Data as Reported to CDC as of 27 Feb 2024 2:00 PM EDT
11/21/2023,2023,12,9.142857551574707,31454,Data as Reported to CDC as of 27 Feb 2024 2:00 PM EDT
11/22/2023,2023,11,9.285714149475098,31465,Data as Reported to CDC as of 27 Feb 2024 2:00 PM EDT
11/23/2023,2023,6,8.571428298950195,31471,Data as Reported to CDC as of 27 Feb 2024 2:00 PM EDT
11/24/2023,2023,6,8.285714149475098,31477,Data as Reported to CDC as of 27 Feb 2024 2:00 PM EDT
11/25/2023,2023,5,7.857142925262451,31482,Data as Reported to CDC as of 27 Feb 2024 2:00 PM EDT
11/26/2023,2023,5,7.5714287757873535,31487,Data as Reported to CDC as of 27 Feb 2024 2:00 PM EDT
11/27/2023,2023,15,8.571428298950195,31502,Data as Reported to CDC as of 27 Feb 2024 2:00 PM EDT
11/28/2023,2023,13,8.714285850524902,31515,Data as Reported to CDC as of 27 Feb 2024 2:00 PM EDT
11/29/2023,2023,6,8,31521,Data as Reported to CDC as of 27 Feb 2024 2:00 PM EDT
11/30/2023,2023,8,8.285714149475098,31529,Data as Reported to CDC as of 27 Feb 2024 2:00 PM EDT
12/01/2023,2023,7,8.428571701049805,31536,Data as Reported to CDC as of 27 Feb 2024 2:00 PM EDT
12/02/2023,2023,6,8.571428298950195,31542,Data as Reported to CDC as of 27 Feb 2024 2:00 PM EDT
12/03/2023,2023,10,9.285714149475098,31552,Data as Reported to CDC as of 27 Feb 2024 2:00 PM EDT
12/04/2023,2023,7,8.142857551574707,31559,Data as Reported to CDC as of 27 Feb 2024 2:00 PM EDT
12/05/2023,2023,8,7.4285712242126465,31567,Data as Reported to CDC as of 27 Feb 2024 2:00 PM EDT
12/06/2023,2023,8,7.714285850524902,31575,Data as Reported to CDC as of 27 Feb 2024 2:00 PM EDT
12/07/2023,2023,14,8.571428298950195,31589,Data as Reported to CDC as of 27 Feb 2024 2:00 PM EDT
12/08/2023,2023,9,8.857142448425293,31598,Data as Reported to CDC as of 27 Feb 2024 2:00 PM EDT
12/09/2023,2023,10,9.428571701049805,31608,Data as Reported to CDC as of 27 Feb 2024 2:00 PM EDT
12/10/2023,2023,10,9.428571701049805,31618,Data as Reported to CDC as of 27 Feb 2024 2:00 PM EDT
12/11/2023,2023,7,9.428571701049805,31625,Data as Reported to CDC as of 27 Feb 2024 2:00 PM EDT
12/12/2023,2023,5,9,31630,Data as Reported to CDC as of 27 Feb 2024 2:00 PM EDT
12/13/2023,2023,5,8.571428298950195,31635,Data as Reported to CDC as of 27 Feb 2024 2:00 PM EDT
12/14/2023,2023,7,7.5714287757873535,31642,Data as Reported to CDC as of 27 Feb 2024 2:00 PM EDT
12/15/2023,2023,9,7.5714287757873535,31651,Data as Reported to CDC as of 27 Feb 2024 2:00 PM EDT
12/16/2023,2023,6,7,31657,Data as Reported to CDC as of 27 Feb 2024 2:00 PM EDT
12/17/2023,2023,6,6.4285712242126465,31663,Data as Reported to CDC as of 27 Feb 2024 2:00 PM EDT
12/18/2023,2023,10,6.857142925262451,31673,Data as Reported to CDC as of 27 Feb 2024 2:00 PM EDT
12/19/2023,2023,5,6.857142925262451,31678,Data as Reported to CDC as of 27 Feb 2024 2:00 PM EDT
12/20/2023,2023,8,7.285714149475098,31686,Data as Reported to CDC as of 27 Feb 2024 2:00 PM EDT
12/21/2023,2023,8,7.4285712242126465,31694,Data as Reported to CDC as of 27 Feb 2024 2:00 PM EDT
12/22/2023,2023,5,6.857142925262451,31699,Data as Reported to CDC as of 27 Feb 2024 2:00 PM EDT
12/23/2023,2023,13,7.857142925262451,31712,Data as Reported to CDC as of 27 Feb 2024 2:00 PM EDT
12/24/2023,2023,7,8,31719,Data as Reported to CDC as of 27 Feb 2024 2:00 PM EDT
12/25/2023,2023,8,7.714285850524902,31727,Data as Reported to CDC as of 27 Feb 2024 2:00 PM EDT
12/26/2023,2023,13,8.857142448425293,31740,Data as Reported to CDC as of 27 Feb 2024 2:00 PM EDT
12/27/2023,2023,5,8.428571701049805,31745,Data as Reported to CDC as of 27 Feb 2024 2:00 PM EDT
12/28/2023,2023,5,8,31750,Data as Reported to CDC as of 27 Feb 2024 2:00 PM EDT
12/29/2023,2023,7,8.285714149475098,31757,Data as Reported to CDC as of 27 Feb 2024 2:00 PM EDT
12/30/2023,2023,8,7.5714287757873535,31765,Data as Reported to CDC as of 27 Feb 2024 2:00 PM EDT
12/31/2023,2023,2,6.857142925262451,31767,Data as Reported to CDC as of 27 Feb 2024 2:00 PM EDT
01/01/2024,2024,6,6.5714287757873535,31773,Data as Reported to CDC as of 27 Feb 2024 2:00 PM EDT
01/02/2024,2024,6,5.5714287757873535,31779,Data as Reported to CDC as of 27 Feb 2024 2:00 PM EDT
01/03/2024,2024,10,6.285714149475098,31789,Data as Reported to CDC as of 27 Feb 2024 2:00 PM EDT
01/04/2024,2024,5,6.285714149475098,31794,Data as Reported to CDC as of 27 Feb 2024 2:00 PM EDT
01/05/2024,2024,10,6.714285850524902,31804,Data as Reported to CDC as of 27 Feb 2024 2:00 PM EDT
01/06/2024,2024,8,6.714285850524902,31812,Data as Reported to CDC as of 27 Feb 2024 2:00 PM EDT
01/07/2024,2024,5,7.142857074737549,31817,Data as Reported to CDC as of 27 Feb 2024 2:00 PM EDT
01/08/2024,2024,5,7,31822,Data as Reported to CDC as of 27 Feb 2024 2:00 PM EDT
01/09/2024,2024,6,7,31828,Data as Reported to CDC as of 27 Feb 2024 2:00 PM EDT
01/10/2024,2024,13,7.4285712242126465,31841,Data as Reported to CDC as of 27 Feb 2024 2:00 PM EDT
01/11/2024,2024,5,7.4285712242126465,31846,Data as Reported to CDC as of 27 Feb 2024 2:00 PM EDT
01/12/2024,2024,10,7.4285712242126465,31856,Data as Reported to CDC as of 27 Feb 2024 2:00 PM EDT
01/13/2024,2024,12,8,31868,Data as Reported to CDC as of 27 Feb 2024 2:00 PM EDT
01/14/2024,2024,3,7.714285850524902,31871,Data as Reported to CDC as of 27 Feb 2024 2:00 PM EDT
01/15/2024,2024,10,8.428571701049805,31881,Data as Reported to CDC as of 27 Feb 2024 2:00 PM EDT
01/16/2024,2024,9,8.857142448425293,31890,Data as Reported to CDC as of 27 Feb 2024 2:00 PM EDT
01/17/2024,2024,10,8.428571701049805,31900,Data as Reported to CDC as of 27 Feb 2024 2:00 PM EDT
01/18/2024,2024,4,8.285714149475098,31904,Data as Reported to CDC as of 27 Feb 2024 2:00 PM EDT
01/19/2024,2024,6,7.714285850524902,31910,Data as Reported to CDC as of 27 Feb 2024 2:00 PM EDT
01/20/2024,2024,7,7,31917,Data as Reported to CDC as of 27 Feb 2024 2:00 PM EDT
01/21/2024,2024,4,7.142857074737549,31921,Data as Reported to CDC as of 27 Feb 2024 2:00 PM EDT
01/22/2024,2024,9,7,31930,Data as Reported to CDC as of 27 Feb 2024 2:00 PM EDT
01/23/2024,2024,5,6.4285712242126465,31935,Data as Reported to CDC as of 27 Feb 2024 2:00 PM EDT
01/24/2024,2024,6,5.857142925262451,31941,Data as Reported to CDC as of 27 Feb 2024 2:00 PM EDT
01/25/2024,2024,4,5.857142925262451,31945,Data as Reported to CDC as of 27 Feb 2024 2:00 PM EDT
01/26/2024,2024,9,6.285714149475098,31954,Data as Reported to CDC as of 27 Feb 2024 2:00 PM EDT
01/27/2024,2024,4,5.857142925262451,31958,Data as Reported to CDC as of 27 Feb 2024 2:00 PM EDT
01/28/2024,2024,2,5.5714287757873535,31960,Data as Reported to CDC as of 27 Feb 2024 2:00 PM EDT
01/29/2024,2024,9,5.5714287757873535,31969,Data as Reported to CDC as of 27 Feb 2024 2:00 PM EDT
01/30/2024,2024,7,5.857142925262451,31976,Data as Reported to CDC as of 27 Feb 2024 2:00 PM EDT
01/31/2024,2024,7,6,31983,Data as Reported to CDC as of 27 Feb 2024 2:00 PM EDT
02/01/2024,2024,6,6.285714149475098,31989,Data as Reported to CDC as of 27 Feb 2024 2:00 PM EDT
02/02/2024,2024,8,6.142857074737549,31997,Data as Reported to CDC as of 27 Feb 2024 2:00 PM EDT
02/03/2024,2024,3,6,32000,Data as Reported to CDC as of 27 Feb 2024 2:00 PM EDT
02/04/2024,2024,1,5.857142925262451,32001,Data as Reported to CDC as of 27 Feb 2024 2:00 PM EDT
02/05/2024,2024,7,5.5714287757873535,32008,Data as Reported to CDC as of 27 Feb 2024 2:00 PM EDT
02/06/2024,2024,3,5,32011,Data as Reported to CDC as of 27 Feb 2024 2:00 PM EDT
02/07/2024,2024,8,5.142857074737549,32019,Data as Reported to CDC as of 27 Feb 2024 2:00 PM EDT
02/08/2024,2024,6,5.142857074737549,32025,Data as Reported to CDC as of 27 Feb 2024 2:00 PM EDT
02/09/2024,2024,6,4.857142925262451,32031,Data as Reported to CDC as of 27 Feb 2024 2:00 PM EDT
02/10/2024,2024,2,4.714285850524902,32033,Data as Reported to CDC as of 27 Feb 2024 2:00 PM EDT
02/11/2024,2024,5,5.285714149475098,32038,Data as Reported to CDC as of 27 Feb 2024 2:00 PM EDT
02/12/2024,2024,1,4.4285712242126465,32039,Data as Reported to CDC as of 27 Feb 2024 2:00 PM EDT
02/13/2024,2024,2,4.285714149475098,32041,Data as Reported to CDC as of 27 Feb 2024 2:00 PM EDT
02/14/2024,2024,9,4.4285712242126465,32050,Data as Reported to CDC as of 27 Feb 2024 2:00 PM EDT
02/15/2024,2024,3,4,32053,Data as Reported to CDC as of 27 Feb 2024 2:00 PM EDT
02/16/2024,2024,3,3.5714285373687744,32056,Data as Reported to CDC as of 27 Feb 2024 2:00 PM EDT
02/17/2024,2024,0,3.2857143878936768,32056,Data as Reported to CDC as of 27 Feb 2024 2:00 PM EDT
02/18/2024,2024,1,2.7142856121063232,32057,Data as Reported to CDC as of 27 Feb 2024 2:00 PM EDT
02/19/2024,2024,1,2.7142856121063232,32058,Data as Reported to CDC as of 27 Feb 2024 2:00 PM EDT
02/20/2024,2024,0,2.4285714626312256,32058,Data as Reported to CDC as of 27 Feb 2024 2:00 PM EDT
02/21/2024,2024,2,1.4285714626312256,32060,Data as Reported to CDC as of 27 Feb 2024 2:00 PM EDT
02/22/2024,2024,0,1,32060,Data as Reported to CDC as of 27 Feb 2024 2:00 PM EDT
02/23/2024,2024,2,0.8571428656578064,32062,Data as Reported to CDC as of 27 Feb 2024 2:00 PM EDT
02/24/2024,2024,0,0.8571428656578064,32062,Data as Reported to CDC as of 27 Feb 2024 2:00 PM EDT
02/25/2024,2024,0,0.7142857313156128,32062,Data as Reported to CDC as of 27 Feb 2024 2:00 PM EDT
02/26/2024,2024,0,0.5714285969734192,32062,Data as Reported to CDC as of 27 Feb 2024 2:00 PM EDT
02/27/2024,2024,1,0.7142857313156128,32063,Data as Reported to CDC as of 27 Feb 2024 2:00 PM EDT